1111111111111
1P00000C00001
1000000000001
100C000000001
10000000000E1
1111111111111