11111111111111
1P00000C000001
10000000000001
100C0000000001
10000000000001
1000000C0000E1
11111111111111