11111
1P001
10B01
1E001
10C01
11111