11111111111111111111111111111111111
11E0000000000000C00000C000000000001
11010010100100000101001000000010101
11010010010101010001001000000010101
11P0000000C00C000000000000000000C11
11111111111111111111111111111111111