NO img/128/duke/north.xpm
SO img/128/duke/south.xpm
WE img/128/duke/west.xpm
EA img/128/duke/east.xpm

F ./img/128/duke/floor.xpm
C ./img/128/duke/ceiling.xpm

        1111111111111111111111111
        1000000000110000000000001
        1011000001110000000000001
        1001000000000000000000001
111111111011000001110000000000001
100000000011000001110111110011111
11110111111111011100000010001
11110111111111011101010010001
11001000110101011100000010001
1001 100000000001100000000P01
10001000000000001101010000001
11000001110101011111011110W0111
11110111 1110101 101111010001
11111111 1111111 111111111111