NO xpm/textures3/text00.xpm
SO xpm/textures3/text01.xpm
WE xpm/textures3/text02.xpm
EA xpm/textures3/text03.xpm

F 255,15,80
C 155,65,180

   1111111111111111111111111         
   10000000000000000000001      
  1000000000000001000000001      
 1000000000000000000000001
100000D00000000000D000001
 1000000000001000000000001
  1000000000000000000000001
   1000000000000000000000001
  1000000000000000000000001
 100000000000N000000000001
1111111111111111111111111
