NO xpm/booba.xpm
SO xpm/textures3/text01.xpm
WE xpm/textures3/text02.xpm
EA xpm/textures3/text03.xpm

F 255,15,80
C 155,65,180

        1111111111111111111111111
        1000000000110000000000001
        1011000001110000000000001
        1001000000000000000000001
111111111011000001110000000000001
1000000001000001110111110011111
11110111111111011100000010001
11110111111111011101010010001
1100D000110101011100000010001
1001 100000000000D00000000001
10001000000000001101010000001
11000001110101011111011110W0111
11110111 1110101 101111010001
11111111 1111111 111111111111
