11111111111111
10101001C01CC1
10010010100001
100000C0C010C1
11E00010C0C001
11000001P00001
11111111111111