11111111111111111111111111
1PC01111111111111111111111
100E1111111111111111111111

