1111111111111111111111111111111111111111
111CE11111111111111111111111111111111111
1PC0111111111111111111111111111111111111
10P1111111111111111111111111111111111111
1C11111111111111111111111111111111111111
10E1111111111111111111111111111111111111
1111111111111111111111111111111111111111
