11111111
10111111
1P111111
1C111111
10111111
1E111111
11111111
